Retention type,Cell type,Number of cells,Number of SC marker genes,Number of ST marker genes,Number of ST lost genes,Retention percentage
unique marker genes,Ext_L23,961,717,299,418,41.7
unique marker genes,Ext_Hpc_DG1,74,321,185,136,57.63
unique marker genes,Ext_Unk_3,307,421,117,304,27.79
unique marker genes,Inh_Sst,315,320,35,285,10.94
unique marker genes,Oligo_2,148,2170,856,1314,39.45
unique marker genes,Ext_Hpc_CA3,56,327,105,222,32.11
unique marker genes,Ext_L56,468,563,212,351,37.66
unique marker genes,Inh_Meis2_4,96,232,82,150,35.34
unique marker genes,Ext_Med,235,425,94,331,22.12
unique marker genes,Endo,73,1494,501,993,33.53
unique marker genes,Inh_6,206,368,128,240,34.78
unique marker genes,Oligo_1,835,579,330,249,56.99
unique marker genes,Ext_Thal_2,635,449,216,233,48.11
unique marker genes,Ext_Unk_1,10,345,151,194,43.77
unique marker genes,Ext_Thal_1,699,938,521,417,55.54
unique marker genes,Ext_ClauPyr,154,200,44,156,22.0
unique marker genes,OPC_2,336,364,109,255,29.95
unique marker genes,Astro_THAL_lat,208,476,163,313,34.24
unique marker genes,Astro_HYPO,192,437,161,276,36.84
unique marker genes,Astro_THAL_hab,136,1112,360,752,32.37
unique marker genes,Ext_Hpc_CA2,115,514,135,379,26.26
unique marker genes,Inh_Meis2_2,106,307,70,237,22.8
unique marker genes,Ext_L5_1,550,467,157,310,33.62
unique marker genes,Inh_4,308,1262,303,959,24.01
unique marker genes,LowQ_1,470,469,230,239,49.04
unique marker genes,Nb_1,26,389,144,245,37.02
unique marker genes,Unk_1,75,1544,667,877,43.2
unique marker genes,Ext_L5_3,152,202,42,160,20.79
unique marker genes,Inh_2,295,1125,224,901,19.91
unique marker genes,Ext_L5_2,301,220,77,143,35.0
unique marker genes,Ext_L6B,288,247,77,170,31.17
unique marker genes,Ext_Pir,901,674,270,404,40.06
unique marker genes,Astro_WM,298,426,184,242,43.19
unique marker genes,Inh_1,335,300,72,228,24.0
unique marker genes,Astro_HPC,45,425,166,259,39.06
unique marker genes,OPC_1,452,420,147,273,35.0
unique marker genes,Ext_Hpc_CA1,128,433,224,209,51.73
unique marker genes,Inh_Meis2_1,81,193,32,161,16.58
unique marker genes,Ext_Amy_1,228,439,195,244,44.42
unique marker genes,Inh_Lamp5,76,182,27,155,14.84
unique marker genes,Ext_Amy_2,728,478,199,279,41.63
unique marker genes,Astro_AMY,63,438,173,265,39.5
unique marker genes,Inh_3,232,286,67,219,23.43
unique marker genes,Micro,74,1049,327,722,31.17
unique marker genes,Astro_AMY_CTX,211,439,230,209,52.39
unique marker genes,Astro_CTX,119,419,147,272,35.08
unique marker genes,Astro_THAL_med,152,480,145,335,30.21
unique marker genes,Inh_Pvalb,108,609,97,512,15.93
unique marker genes,Inh_5,59,250,92,158,36.8
unique marker genes,Inh_Meis2_3,415,362,131,231,36.19
unique marker genes,Unk_2,173,633,252,381,39.81
unique marker genes,LowQ_2,143,177,42,135,23.73
unique marker genes,Nb_2,121,480,130,350,27.08
unique marker genes,Ext_L6,253,284,67,217,23.59
unique marker genes,Ext_L25,346,456,130,326,28.51
unique marker genes,Ext_Hpc_DG2,90,418,136,282,32.54
unique marker genes,Astro_STR,53,723,304,419,42.05
unique marker genes,Ext_Unk_2,68,251,57,194,22.71
unique marker genes,Inh_Vip,186,190,23,167,12.11
top 100 marker genes,Ext_L23,961,98,91,7,92.86
top 100 marker genes,Ext_Hpc_DG1,74,93,77,16,82.8
top 100 marker genes,Ext_Unk_3,307,97,41,56,42.27
top 100 marker genes,Inh_Sst,315,97,55,42,56.7
top 100 marker genes,Oligo_2,148,94,78,16,82.98
top 100 marker genes,Ext_Hpc_CA3,56,94,73,21,77.66
top 100 marker genes,Ext_L56,468,100,81,19,81.0
top 100 marker genes,Inh_Meis2_4,96,93,39,54,41.94
top 100 marker genes,Ext_Med,235,96,42,54,43.75
top 100 marker genes,Endo,73,95,28,67,29.47
top 100 marker genes,Inh_6,206,94,55,39,58.51
top 100 marker genes,Oligo_1,835,88,75,13,85.23
top 100 marker genes,Ext_Thal_2,635,97,65,32,67.01
top 100 marker genes,Ext_Unk_1,10,96,48,48,50.0
top 100 marker genes,Ext_Thal_1,699,99,82,17,82.83
top 100 marker genes,Ext_ClauPyr,154,91,59,32,64.84
top 100 marker genes,OPC_2,336,91,48,43,52.75
top 100 marker genes,Astro_THAL_lat,208,87,35,52,40.23
top 100 marker genes,Astro_HYPO,192,88,38,50,43.18
top 100 marker genes,Astro_THAL_hab,136,95,27,68,28.42
top 100 marker genes,Ext_Hpc_CA2,115,95,49,46,51.58
top 100 marker genes,Inh_Meis2_2,106,95,50,45,52.63
top 100 marker genes,Ext_L5_1,550,98,90,8,91.84
top 100 marker genes,Inh_4,308,99,48,51,48.48
top 100 marker genes,LowQ_1,470,89,63,26,70.79
top 100 marker genes,Nb_1,26,94,37,57,39.36
top 100 marker genes,Unk_1,75,94,48,46,51.06
top 100 marker genes,Ext_L5_3,152,93,33,60,35.48
top 100 marker genes,Inh_2,295,99,41,58,41.41
top 100 marker genes,Ext_L5_2,301,92,55,37,59.78
top 100 marker genes,Ext_L6B,288,97,53,44,54.64
top 100 marker genes,Ext_Pir,901,97,92,5,94.85
top 100 marker genes,Astro_WM,298,93,50,43,53.76
top 100 marker genes,Inh_1,335,96,69,27,71.88
top 100 marker genes,Astro_HPC,45,88,47,41,53.41
top 100 marker genes,OPC_1,452,94,43,51,45.74
top 100 marker genes,Ext_Hpc_CA1,128,98,89,9,90.82
top 100 marker genes,Inh_Meis2_1,81,95,31,64,32.63
top 100 marker genes,Ext_Amy_1,228,95,79,16,83.16
top 100 marker genes,Inh_Lamp5,76,93,26,67,27.96
top 100 marker genes,Ext_Amy_2,728,98,89,9,90.82
top 100 marker genes,Astro_AMY,63,87,40,47,45.98
top 100 marker genes,Inh_3,232,97,36,61,37.11
top 100 marker genes,Micro,74,99,52,47,52.53
top 100 marker genes,Astro_AMY_CTX,211,90,34,56,37.78
top 100 marker genes,Astro_CTX,119,90,33,57,36.67
top 100 marker genes,Astro_THAL_med,152,87,30,57,34.48
top 100 marker genes,Inh_Pvalb,108,97,35,62,36.08
top 100 marker genes,Inh_5,59,94,39,55,41.49
top 100 marker genes,Inh_Meis2_3,415,99,75,24,75.76
top 100 marker genes,Unk_2,173,95,36,59,37.89
top 100 marker genes,LowQ_2,143,89,29,60,32.58
top 100 marker genes,Nb_2,121,92,32,60,34.78
top 100 marker genes,Ext_L6,253,97,76,21,78.35
top 100 marker genes,Ext_L25,346,97,86,11,88.66
top 100 marker genes,Ext_Hpc_DG2,90,98,72,26,73.47
top 100 marker genes,Astro_STR,53,96,37,59,38.54
top 100 marker genes,Ext_Unk_2,68,95,39,56,41.05
top 100 marker genes,Inh_Vip,186,93,33,60,35.48
